1
30
0
0
0
0
0
0
3 4 5 2 1 4 2
4 2 4 2 1 3 6
1 3 5 1 3 4 2
4 5 3 2 6 2 4
6 3 1 4 1 4 5
2 1 6 3 2 1 3
5 6 2 5 3 4 1 